###############
# #....##. ...#
#.# ......#.#.#
#.#.o..... ...#
#. ..#..#. #..#
##           .#
## ###   ### .#
   #       # . 
#. ######### .#
#.           ##
#....#..#... .#
#...#.. #.#.# #
#.......#... .#
#..#.. .#.  .##
###############
--end-maze--
0
9
7
1.0
L
1
0
Pacman
0.0
Closed
Normal
1
7
7
1.0
R
1
1
Ghost
Alive
--end-players--
5
