###############
# #....##. ...#
#.# ......#.#.#
#.#.o..... ...#
#. ..#..#. #..#
##           .#
## ###   ### .#
   #       # . 
#. ######### .#
#.           ##
#....#..#... .#
#...#.. #.#.# #
#.......#... .#
#..#.. .#.  .##
###############
--end-maze--
0
7
0
1.0
L
1
1
Pacman
0.0
Open
Normal
1
7
14
1.0
R
1
1
Ghost
Alive
--end-players--
5
