####################
# # ..#..... ....###
#.... ....##..#...##
##......##... .....#
#..##... .#.###.#. #
# #..... ...#..#.. #
#.#.#.##...#.......#
#.o.o          ....#
#...# ###  ###  .#.#
 .... #      # .... 
 ..o. ######## ...# 
##.##          #...#
#....#.....###. .#.#
#........#......#..#
#.... ....o...#### #
#.....#..... ...#..#
#.#.##..o.. .... o##
# ......##  #... ..#
#..... ..........#.#
####################
--end-maze--
0
10
19
1.0
L
1
1
Pacman
0.0
Closed
Normal
--end-players--
5
