###################
# .... . .. .. ..##
##..##..####... ..#
#.#. ......o...#..#
# #.###.#...#.....#
#.#..o#..# .#... .#
# ..........#.....#
###.           ...#
#..# ###   ### ...#
 ... #       # ... 
#.#. ######### .###
#.##           ...#
#...... ...#......#
#.#. .#....#..###.#
#.##.##......##...#
#... . ...#.... ..#
######......####..#
#... .o#.o..  ....#
###################
--end-maze--
0
9
0
1.0
R
1
1
Pacman
0.0
Open
Normal
--end-players--
5
