###############
#  ...#. .#...#
###.........# #
#....#..#..#..#
#..#...#...#.##
#.           .#
#. ###   ### .#
 . #       #   
#. ######### .#
#.           .#
###....... ..##
#.# .###....###
#..##...#..####
##  ..#.. #####
###############

--end-maze--
0
1
5
1.0
R
2
1
Pacman
0.0
Open
Normal
--end-players--
5
