###############
# ......v.... #
#.           .#
## ###   ### .#
 . #       # . 
 . ######### . 
#            .#
# .....##.....#
#........# ...#
###############
--end-maze--
0
1
8
1.0
U
2
1
Pacman
0.0
Closed
Normal
--end-players--
5
