###############
# ...... <... #
#.           .#
## ###   ### .#
 . #       # . 
 . ######### . 
#            .#
# .....##.....#
#........# ...#
###############
--end-maze--
0
1
9
1.0
R
6
1
Pacman
10000.0
Closed
Mega
--end-players--
5
