#########################
#o>....................o#
#o.....................o#
#.######.........######.#
 .#    #.### ###.#    #. 
 .#    #.#  M  #.#    #. 
#.######.#######.######.#
#o...................?.o#
#########################
--end-maze--
0
1
2
1.0
L
1
1
Pacman
0.0
Closed
Normal
--end-players--
5
