#########################
#o  ...................o#
#o.....................o#
#.######.........######.#
 .#    #.### ###.#    #. 
 .#    #.#     #.#    #. 
#.######.#######.######.#
#o................... .o#
#########################
#########################
#########################
--end-maze--
0
1
3
1.0
R
12
1
Pacman
4750.0
Closed
Mega
1
5
12
1.0
L
1
1
Ghost
Alive
--end-players--
5
