###############
# ........... #
#.           |#
## ###   ### .#
 . #       # . 
 . ######### . 
#            .#
# .....##.....#
#........# ...#
###############
--end-maze--
0
2
13
1.0
D
2
1
Pacman
0.0
Closed
Normal
--end-players--
5
