###############
# ........... #
#.     V     .#
## ###   ### .#
 . #       # . 
 . ######### . 
#            .#
# .....##.....#
#........# ...#
###############
--end-maze--
0
2
8
1.0
U
1
1
Pacman
0.0
Open
Normal
--end-players--
5
