################
# .......  #.. #
#...#.#..###..##
###...#.#.....##
# .#..........##
#......#.o#..###
#..          ###
# . ###  ### ..#
 .. #      #  . 
#.  ######## o #
#..          ..#
#.....#........#
#....  ....#.. #
#. ....#. ..#..#
#.......  #...##
#.......#......#
################
--end-maze--
0
1
14
1.0
R
16
1
Pacman
10000.0
Open
Mega
1
8
7
1.0
L
1
1
Ghost
Alive
--end-players--
5
