#########################
#o ....................o#
#o.....................o#
#.######.........######.#
 .#    #.### ###.#    #. 
 .#    #.#     #.#    #. 
#.######.#######.######.#
#o................... .o#
#########################
#########################
#########################
--end-maze--
0
1
2
1.0
R
1
1
Pacman
5000.0
Open
Mega
1
1
3
1.0
L
1
1
Ghost
Dead
--end-players--
5
