#########################
#} ....................o#
#o.....................o#
#.######.........######.#
 .#    #.### ###.#    #. 
 .#    #.#  M  #.#    #. 
#.######.#######.######.#
#o...................?.o#
#########################
--end-maze--
0
1
1
1.0
L
6
1
Pacman
10000.0
Open
Mega
--end-players--
5
