###############
# ...........^#
#.           .#
## ###   ### .#
 . #       # . 
 . ######### . 
#            .#
# .....##.....#
#........# ...#
###############
--end-maze--
0
1
13
1.0
D
1
1
Pacman
0.0
Open
Normal
--end-players--
5
