################
# . ....#......#
#..##.#....#.#.#
#.  ....#..... #
##..##.##...#..#
# .          ..#
#.# ###  ### ..#
 .. #      # .  
 #. ######## .. 
#..          ###
#..o. .........#
# #.#.#........#
#....#.. .... .#
# .#..  ....#..#
#.###.. ....# .#
################
--end-maze--
0
1
3
1.0
D
1
1
Pacman
0.0
Closed
Normal
--end-players--
5
