################
# ...#.......#.#
##. .#.. .#....#
#..... #..... ##
#.#.#....#.###.#
#..          ..#
#.  ###  ### ..#
  . #      # .. 
 .. ######## .. 
#..          ..#
#..... . ......#
# ... ........ #
#.#.#. .#......#
#. . .##..##...#
##. .#.. #.....#
################
--end-maze--
0
13
5
1.0
R
1
1
Pacman
0.0
Open
Normal
--end-players--
5
