#########################
#o.....................o#
#.######. ......M######.#
 .#    #.### ###.#    #. 
 .#    #.#     #.#    #. 
#.######.#######.######.#
#o...........    ^... .o#
#########################
