####################
#.V ........#.....M#
#...##..#.#.#......#
#.......#...#...## #
#.#......#.#. ....M#
#....#.......#.#...#
#............#.#...#
##o..          ....#
#.### ###  ### .#..#
 .... #     M# .... 
 #... ######## ##.. 
#...#          ....#
#..#...#..#........#
#.....##....#....#.#
#....o...........###
#...#....#.#.......#
#.##....#.......#..#
#...........#......#
##....#............#
####################

