####################
#......M#....#...#.#
#..o.##......##....#
#.##..#...........##
#.....###.#..#.....#
#..#.o..#......#...#
#.o.....##..#......#
##.#.          .##.#
#.... ###  ### ....#
 <... #      # ...M 
 ##.. ######## .... 
#....          ....#
#..................#
#..#..........#....#
#........#.........#
#...............#..#
#....#......#...#..#
#......#........#..#
#M........##...#..M#
####################

