####################
#.......#....#...#.#
#..o.##...M..##....#
#.##..#...........##
#.....###.#..#.....#
#..#.o..#......#...#
#.o.....##..#......#
##.#.          .##.#
#.... ###  ### ....#
 <... # M    # ...M 
 ##.. ######## .... 
#....          ....#
#..................#
#..#..........#....#
#........#.........#
#...............#..#
#....#......#...#..#
#......#..M.....#..#
#.........##...#...#
####################

