1
###############
# ......##. .##
###...#...##..#
#.............#
#.....#....#..#
#.           .#
#  ###   ### .#
   #       # . 
#. ######### .#
##           .#
# .... ... # o#
#.#... ## ...##
#....#.. .... #
#....#..... . #
###############
--end-maze--
0
5
5
1.0
R
1
1
Pacman
0.0
Open
Normal
1
5
6
1.0
L
1
1
Ghost
Alive
--end-players--
5
