2
#########################
#o ....................o#
#o.....................o#
#.######.........######.#
 .#    #.### ###.#    #. 
 .#    #.#     #.#    #. 
#.######.#######.######.#
#o..................  .o#
#########################
--end-maze--
0
1
3
0.5
R
1
1
Ghost
Dead
1
7
21
1.0
L
1
1
Pacman
5000.0
Closed
Mega
--end-players--
5
