2
#########################
#o ....................o#
#o.....................o#
#.######.........######.#
 .#    #.### ###.#    #. 
 .#    #.#     #.#    #. 
#.######.#######.######.#
#o...................?.o#
#########################
--end-maze--
0
1
3
0.5
R
1
1
Ghost
Dead
--end-players--
5
