2
#########################
#o                     o#
#  ....................o#
#.######.........######.#
 .#    #.### ###.#    #. 
 .#    #.#     #.#    #. 
#.######.#######.######.#
#o................... .o#
#########################
--end-maze--
0
2
1
1.0
L
6
1
Pacman
10000.0
Closed
Mega
1
1
5
0.5
L
0
1
Ghost
Dead
--end-players--
5
