2
#########################
#o                     o#
#o.....................o#
#.######.........######.#
 .#    #.### ###.#    #. 
 .#    #.#     #.#    #. 
#.######.#######.######.#
#o................... .o#
#########################
--end-maze--
0
1
3
1.0
R
1
1
Pacman
0.0
Closed
Normal
1
1
5
1.0
L
1
1
Ghost
Alive
--end-players--
5
