1
#########################
#o                     o#
#o ....................o#
#.######.........######.#
 .#    #.### ###.#    #. 
 .#    #.#     #.#    #. 
#.######.#######.######.#
#o................... .o#
#########################
--end-maze--
0
2
2
1.0
L
1
1
Pacman
0.0
Open
Normal
1
1
6
1.0
L
0
1
Ghost
Alive
--end-players--
5
